000000000000000000000000000000
000000000000000000000000000000
000000000000000000000l00000000
0e0c0b000000000000000000000000
gggggg00000000l000000000000000
000000000000000000000000000000
000000000000ggg000000000000000
000000000000000000000000000000
000000000000000000000000000000
0000000cb0c0000000000000000000
0000000gggg0000000000000000000
000000000000000gg0000000000000
00000000000000000000000jcj0000
0000000000000000000000ggggg000
00000000000000000gg00000000000
0000000c0000000000000000000000
00p00b00b00t00bc0000000000jc00
gggggg00gggggggggggg0000gggggg